<fstream>
<iomanip>
<ios>
<iosfwd>
<iostream>
<istream>
<ostream>
<sstream>
<streambuf>

Classes:
ios_base : Base class for streams (class )
ios : Base class for streams (type-dependent components) (class )
istream : Input stream (class )
ostream : Output Stream (class )
iostream : Input/output stream (class )
ifstream : Input file stream class (class )
ofstream : Output file stream (class )
fstream : Input/output file stream class (class )
istringstream : Input string stream (class )
ostringstream : Output string stream (class )
stringstream : Input/output string stream (class )
streambuf : Base buffer class for streams (class )
filebuf : File stream buffer (class )
stringbuf : String stream buffer (class )

Objects:
cin : Standard input stream (object )
cout : Standard output stream (object )
cerr : Standard output stream for errors (object )
clog : Standard output stream for logging (object )

Types:
fpos : Stream position class template (class template )
streamoff : Stream offset type (type )
streampos : Stream position type (type )
streamsize : Stream size type (type )

Manipulators:
boolalpha : Alphanumerical bool values (function )
dec : Use decimal base (function )
endl : Insert newline and flush (function )
ends : Insert null character (function )
fixed : Use fixed floating-point notation (function )
flush : Flush stream buffer (function )
hex : Use hexadecimal base (function )
internal : Adjust field by inserting characters at an internal position (function )
left : Adjust output to the left (function )
noboolalpha : No alphanumerical bool values (function )
noshowbase : Do not show numerical base prefixes (function )
noshowpoint : Do not show decimal point (function )
noshowpos : Do not show positive signs (function )
noskipws : Do not skip whitespaces (function )
nounitbuf : Do not force flushes after insertions (function )
nouppercase : Do not generate upper case letters (function )
oct : Use octal base (function )
resetiosflags : Reset format flags (function )
right : Adjust output to the right (function )
scientific : Use scientific floating-point notation (function )
setbase : Set basefield flag (function )
setfill : Set fill character (function )
setiosflags : Set format flags (function )
setprecision : Set decimal precision (function )
setw : Set field width (function )
showbase : Show numerical base prefixes (function )
showpoint : Show decimal point (function )
showpos : Show positive signs (function )
skipws : Skip whitespaces (function )
unitbuf : Flush buffer after insertions (function )
uppercase : Generate upper-case letters (function )
ws : Extract whitespaces (function )
